4 ગુજરાતીઓના મોતનો મામલો: કેનેડા-US બોર્ડર પર થીજીને મૃત્યુ પામેલા પટેલ પરિવારના 4 મૃતદેહો ભારત નહીં લવાય, કેનેડામાં જ અગ્નિ સંસ્કાર થશે
4 ગુજરાતીઓના મોતનો મામલો: કેનેડા-US બોર્ડર પર થીજીને મૃત્યુ પામેલા પટેલ પરિવારના 4 મૃતદેહો ભારત નહીં લવાય, કેનેડામાં જ અગ્નિ સંસ્કાર થશે
કેનેડા પોલીસની તપાસ: 12 તારીખે કેનેડામાં ટોરેન્ટો ખાતે પહોંચેલો આ પરિવાર 18 જાન્યુઆરીએ બોર્ડર ક્રોસ કરવા રવાના થયો હતો
કેનેડા પોલીસની તપાસ: 12 તારીખે કેનેડામાં ટોરેન્ટો ખાતે પહોંચેલો આ પરિવાર 18 જાન્યુઆરીએ બોર્ડર ક્રોસ કરવા રવાના થયો હતો
ડિંગુચાથી ગ્રાઉન્ડ રિપોર્ટ: મીડિયાને જોઈ ગામલોકો ભડકે છે, કહ્યું- 'ગામના છોકરાઓની સગાઈ નહીં થાય, અનામતનો લાભ મળતો હોય તો આવા દિવસો ના આવે'
ડિંગુચાથી ગ્રાઉન્ડ રિપોર્ટ: મીડિયાને જોઈ ગામલોકો ભડકે છે, કહ્યું- 'ગામના છોકરાઓની સગાઈ નહીં થાય, અનામતનો લાભ મળતો હોય તો આવા દિવસો ના આવે'
હવે ઠંડીનું જોર ઘટશે: રાજ્યના મોટાભાગના શહેરોમાં તાપમાનમાં 3 ડિગ્રી સુધીનો વધારો થતાં ઠંડીમાં ઘટાડો થવાની શક્યતા, 5.2 ડિગ્રી સાથે નલિયા ઠંડુગાર
આખરે અટકળોનો અંત આવ્યો: કેનેડા-યુએસ બોર્ડર પર બરફ નીચે થીજી જનારાં મૃતકો ગાંધીનગરના પટેલ પરિવારનાં જ, કેનેડા પોલીસે સત્તાવાર પુષ્ટિ કરી
મહેફિલ માણતા નેતા!: મહેમદાવાદના પૂર્વ MLA ગૌતમ ચૌહાણ દારૂની પાર્ટી કરતા ઝડપાયા, ખેડા પોલીસે અન્ય સાતની પણ અટકાયત કરી
આ આતંક કયારે બંધ થશે?: ગુજરાતભરમાં રખડતાં ઢોરોનો ત્રાસ, કોઈને આખલાએ ઢસડીનો મોતને ઘાટ ઉતાર્યા તો કોઈને રસ્તા પર રગદોળ્યા
ઇતિહાસ ભુલાય છે, પણ ભૂંસાતો નથી: જ્યારે અર્ધલશ્કરી દળના મુઠ્ઠીભર જવાનોએ પાકિસ્તાનની બ્રિગેડને હરાવી !
નાપાક: મુન્દ્રા પોર્ટ પર 10 કન્ટેનરમાંથી પાકિસ્તાન આર્મીનો સરંજામ મળ્યો
બાંધકામ વેસ્ટ થશે રિસાઇકલ: મનપાને મળશે પ્રતિ ટન 57 રૂપિયા, વેસ્ટ બદલ પ્રીમિયમ લેનારી દેશની પ્રથમ મહાપાલિકા
ભાસ્કર એક્સક્લૂઝિવ: 4 મહિનામાં અમદાવાદ સિવિલમાં 15થી વધુ કિડની ટ્રાન્સપ્લાન્ટ ફેલ, કારણ કે રાજ્ય સરકાર જરૂરી ઇન્જેક્શન દિલ્હીથી મગાવી શકી નહીં
રાજકીય માહોલ ગરમાયો: નરેશ પટેલ, શંકરસિંહ, અલ્પેશ કથીરિયાનું કોંગ્રેસમાં સ્વાગત: રઘુ શર્મા,પ્રદેશ પ્રભારી
વિધાનસભા ચૂંટણીની તૈયારી: ઉત્તર પ્રદેશનાં પરિણામોના આધારે ગુજરાતની ચૂંટણીનો નિર્ણય લેવાશે
શિક્ષણ: MBBSની પરીક્ષામાંથી 5 ‘મુન્નાભાઈ’ પકડાયા મોબાઇલમાં PDF જોઈને જવાબો લખતા હતા
ભૂકંપ: વલસાડમાં ગણતંત્ર દિને ભૂકંપના આંચકાથી અમુક વિસ્તારોમાં ભય
સ્કીલ ડેવલપમેન્ટ: સ્કિલ ડેવલોપમેન્ટ પ્રોજેકટ: દેશના 30 જિલ્લામાં સુરેન્દ્રનગરનો સમાવેશ
વિદ્યાર્થીઓને ભારે હાલાકી: 152 વર્ષ જૂની સંસ્કૃત પાઠશાળામાં બે મુખ્ય વિષયના શિક્ષકની જગ્યા ખાલી, છાત્રો હેરાન
આત્મહત્યા: સુઈગામ પાસે ભારત-પાક બોર્ડરે BSF જવાને ગોળી મારી આપઘાત કર્યો
સ્મૃતિ ચિન્હ અર્પણ: જૂનાગઢ-પોરબંદર જિલ્લાના 7 શહીદ સૈનિકોને એનસીસી કેડેટોની સલામી
ડૂપ્લીકેટ લાયસન્સ સામે આવ્યા: અમરેલીમાં ડૂપ્લીકેટ ડ્રાઇવીંગ લાયસન્સનું કૌભાંડ
વલસાડ કોરોના LIVE: જિલ્લામાં ગુરુવારે નવા 171 કેસ નોંધાતા એક્ટિવ કેસનો આંક 1646 પર પહોંચ્યો, એક વૃદ્ધનું મોત
ધંધુકાની ઘટનાના પડઘા રાણપુરમાં પડ્યા: રાણપુરમાં વેપારીઓએ સ્વૈચ્છિક બંધ પાળ્યો, ગૃહ રાજ્યમંત્રી મૃતકના પરિવારની મુલાકાત કરી શકે
ભાવનગર કોરોના LIVE: જિલ્લામાં બે દિવસમાં કોરોનાનું સંક્રમણ ધીમું પડ્યું, નવા કેસ મળ્યા તેનાથી સવા બે ગણા દર્દી ડિસ્ચાર્જ થયા
MLAના કાર્યાલય પણ સુરક્ષિત નથી: ડભોઇના ભાજપના ધારાસભ્યના જનસંપર્ક કાર્યાલયમાં ચોરીનો પ્રયાસ, શૈલેષ સોટ્ટાએ કહ્યું: 'તસ્કરોએ ઉત્પાત મચાવ્યો છે. તંત્ર આળસ ખંખેરતુ નથી, ગૃહમંત્રીને રજૂઆત કરીશ'
રાજકોટના નિષ્ણાત તબીબોની ચેતવણી: દર્દીના રિપોર્ટમાં લિમ્ફોસાઇટ્સ ફરી ઓછા દેખાયા, CT સ્કોર વધ્યો, હવે ઓમિક્રોન નાક-ગળા પૂરતો સીમિત નહીં ફેફસા સુધી પહોંચ્યો, મોત વધ્યા
કચ્છ કોરોના LIVE: જિલ્લામાં રસીકરણમાં બાકી રહી ગયેલા લોકોનને 5 દિવસ દરરોજ સાંજે 5 થી 8 સુધી રસી અપાશે
દબાણ હટાવ ઝૂંબેશ: અંજાર પોલીસે શહેરના મુખ્ય બજારમાં હંગામી દબાણો હટાવી વેપારીઓને ટ્રાફિકના નિયમોનું પાલન કરવા તાકીદ કરી
જૂનાગઢ કોરોના LIVE: જિલ્લામાં ગુરુવારે કોરોનાના કેસોમાં નોંધપાત્ર ઘટાડો, 51 નવા કેસો અને 108 ડિસ્ચાર્જ કરાયા
જામનગર કોરોના LIVE: જિલ્લામાં ગુરુવારે કોરોનાના નવા 215 કેસ નોંધાયા, 4 દર્દીઓના સારવાર દરમિયાન મોત
આરોપી ઓરિસ્સાથી ઝડપાયો: સાડા ત્રણ માસ પૂર્વે સગીરાને ભગાડી જનારા શખ્સને હળવદ પોલીસે ઓરિસ્સાથી ઝડપ્યો, સગીરાને મુક્ત કરાવી પરિવારને સોંપાઈ
ગાડી વચ્ચે નીલગાય આવી જતાં ગમખ્વાર અકસ્માત: ડીસા-થરાદ હાઇવે ઉપર આગથળા નજીક ગાડી ફંગોળાઈને ખેતરમાં ઘૂસી ગઈ, ઘટનાસ્થળે જ એકનું મોત, ચાર ઈજાગ્રસ્ત
આણંદ કોરોના LIVE: જિલ્લામાં ગુરુવારે નવા 196 કેસ નોંધાતા એક્ટિવ કેસનો આંક 1961 થયો
સબસીડીમાં ગોટાળા બાબતે રજૂઆત: નાના રણમાં સોલાર યોજનામાં ગેરરીતિ મામલે અગરિયાઓને યોગ્ય વળતર ચૂકવવા માંગ, અગરિયા સમુદાયે મુખ્યમંત્રીને અપીલ કરી
કોરોના વડોદરા LIVE: MS યુનિવર્સિટીની બે ફેકલ્ટીના બે ડીન કોરોના સંક્રમિત થયા, છેલ્લા 36 કલાકમાં કોરોનાના નવા 2395 કેસ નોંધાયા
દાહોદ કોરોના LIVE: જિલ્લામાં ગુરુવારે કોરોનાના નવા 37 કેસ નોંધાયા, કુલ એક્ટિવ કેસનો આંક 345 પર પહોંચ્યો
ખેડા કોરોના LIVE: જિલ્લામાં ગુરુવારે કોરોનાના નવા 144 કેસ નોંધાયા, એક્ટિવ કેસોની સંખ્યા 723 પર પહોંચી
તળાવ છલકાતાં રાહદારીઓ પરેશાન: મયુરનગરના તાણાસર તળાવમાં પેટા કેનાલનું પાણી વધુ માત્રામાં છોડાતાં પાણી રોડ પર ફરી વળ્યાં, ખેડૂતોને ખેતરે જવું મુશ્કેલ બન્યું
નવસારી કોરોના LIVE: જિલ્લામાં ગુરુવારે કોરોનાના 142 કેસ નોંધાયા, એકનું મોત; એક્ટિવ કેસની સંખ્યા 1005 થઈ
જાહેરનામાના ભંગ બદલ કાર્યવાહી: વડોદરાના ગોત્રી વિસ્તારમાં રાત્રિ કર્ફ્યૂ હોવા છતાં રસ્તા પર ધંધો કરતા ત્રણ લારીવાળા ઝડપાયા
મહેસાણા કોરોના LIVE: જિલ્લામાં ગુરુવારે નવા 302 કેસ નોંધાયા, 353 દર્દીને ડિસ્ચાર્જ કરાયા
દુર્ઘટના: સુરતમાં ઘરના ફ્રિઝમાં શોર્ટ સર્કિટથી આગ લાગી, પાડોશીઓની સતર્કતાથી રહિશોનો બચાવ, ફર્નિચર બળીને ખાક
ગાંધીનગર કોરોના LIVE: જિલ્લામાં ગુરુવારે નવા 522 કેસ નોંધાયા, બે દિવસમાં જ 1268 કેસ નોંધાતા ફફડાટ
પરીક્ષા મોકૂફ રાખવા માંગ: ગુજરાત યુનિવર્સિટીએ LLM સેમેસ્ટર-3ની 1 ફેબ્રુઆરીએ શરૂ થતી પરીક્ષાની 4 દિવસ અગાઉ જાણ કરતાં વિદ્યાર્થીઓ મુંઝાયા
વધુ એક રોમિયો ઝડપાયો: વડોદરાના ખંડેરાવ શાકમાર્કેટમાં મહિલાઓને જોઇને બિભત્સ ચેનચાળા કરતા યુવાનની શી ટીમે ધરપકડ કરી
પાટણ કોરોના LIVE: જિલ્લામાં ગુરુવારે કોરોનાના વધુ 270 કેસો નોંધાયા, સૌથી વધુ પાટણમાં 114 કેસ
બનાસકાંઠા કોરોના LIVE: જિલ્લામાં ગુરુવારે નવા 243 કેસ નોંધાયા, એક્ટિવ કેસનો આંક 1100ને પાર પહોંચ્યો
સુરેન્દ્રનગર કોરોના LIVE: જિલ્લામાં 26 તારીખ તારીખે 64 અને 27મીએ 70 કેસ મળી બે દિવસમાં 134 નવા કેસ નોંધાયા
કોરોના સુરત LIVE: વિતેલા 24 કલાકમાં નવા કેસ કરતાં ડિસ્ચાર્જની સંખ્યા વધુ, નવા 1094 કેસ, એક દર્દીનું મોત, એક્ટિવ કેસની સંખ્યા ઘટી 12,564
કોરોના રાજકોટ LIVE: શહેરમાં બે દિવસમાં 1952 પોઝિટિવ કેસ સામે 2588 દર્દી ડિસ્ચાર્જ, ફેબ્રુઆરીનાં ત્રીજા સપ્તાહમાં દૈનિક કેસ શૂન્ય આવે તેવી શક્યતા
પોલીસની રેકી?: સુરતમાં PCR વાન જતાની સાથે જ 31 મિનિટમાં તસ્કરોએ બે ગોડાઉન સહિત 3 દુકાનના તાળાં તોડ્યાં
અટકાયત: કુંભાણીમાં 40 હજારના ખેરના લાકડાં ચોરતા 6ની અટકાયત
પ્રતિમાનું અનાવરણ: અટલનગરમાં વાજપેયીની પૂર્ણકદની પ્રતિમા મૂકાઈ
ટ્રક પલટી: વનાર જામલા રોડ ઉપર પથ્થર ભરેલી ટ્રક પલટી ખાતાં 2 શ્રમિકોનાં મોત થયાં
હાલાકી: શહેરના સ્ટેશન રોડ ઉપર 20 દિવસમાં ત્રીજી વખત ગટરની લાઈન બેસી ગઇ
કોરોના કહેર: છોટાઉદેપુર જિલ્લામાં ગુરુવારે કોરોનાના 14 કેસ સાથે કુલ આંક 144, 10 ડિસ્ચાર્જ
જામીન નાંમજુર: ગોધરામાં બે પાસપોર્ટ બનાવનાર મહિલાના જામીન નાંમજુર થયા
વાહનવેરો: 10થી 25 લાખની કાર લેનારા પાસેથી 35થી 87 હજાર જ્યારે 25 લાખથી વધુ કિંમતની કાર પર 1 લાખ ટેક્સ વસૂલાશે, ઇલેક્ટ્રિક કાર ખરીદનારને કોઈ ટેક્સ
ઠંડીમાંથી રાહત મળશે: કચ્છમાં હજુ આજે કોલ્ડ વેવ : કાલથી ઠારમાંથી આંશિક રાહતની શક્યતા
માતાપિતાને સમર્પિત: 75 તળાવો બનાવી 22 લાખ વૃક્ષો ઉગાડનાર સવજીભાઇને પદ્મશ્રી
હુમલો: ગોધરામાં વોન્ટેડ આરોપીઓને પકડવા ગયેલી SOG પોલીસ ટીમ પર હુમલો
કાર્યવાહી: હોસ્પિટલના ટ્રસ્ટી સામે લેન્ડ ગ્રેબીંગનો ગુનો નોંધો
અપહરણ: 14 વર્ષિય સગીરાનું લગ્નને ઇરાદે અપહરણ
ઇન્સપાયર એવોર્ડનું આયોજન: પોરબંદરના તરૂણે પાંખીયા વગરનો પંખો બનાવ્યો
તંત્રને હાશ: પંચમહાલમાં બે દિવસમાં 113 લોકો પોઝિટીવ સામે 152 દર્દી સાજા થયાં
જન્મ જયંતીની ઉજવણી: વિવેદાનંદ અને સુભાષચંદ્ર બોઝના કામોને યાદ કરાયા
સન્માન: દમણના પ્રભાબેન શાહને પદ્મશ્રી એવોર્ડ એનાયત, 92 વર્ષના પ્રભાબેને 67 વર્ષ સેવાકીય પ્રવૃતિ કરી
ભાસ્કર એક્સકલૂઝિવ: અગાસીની ટાંકી કરતાં ઘરમાં છીછરા વાસણમાં ભરેલું પાણી વધુ શીતળ હોય છે, તળાવમાં દોઢ ફૂટ સુધી વધુ ઠંડું અને એની નીચે હૂંફાળું નીર હોય છે
ત્રીજી લહેર માટે સજ્જ: જો લક્ષણ જણાય તો ઘરે પણ એકલાજ બેસીને જમવું જોઇએ
રજૂઆત: પાલિકાની સામાન્ય સભાનું વીડિયો રેકોર્ડીંગ કરવા કોંગ્રેસ દ્વારા માગણી
કોર્ટે નારાજગી દર્શાવી: 21 વર્ષ પહેલા હુકમ કર્યો કે 7 કર્મચારીને કાયમી કરો, પણ કોઈ કાર્યવાહી ન થતાં હાઈકોર્ટે સરકારને કહ્યું, શું તમે સૌરાષ્ટ્ર યુનિ.ની માન્યતા રદ કરશો?
ભાસ્કર વિશેષ: ફેફસાં ડેમેજ અને હૃદય ફૂલી જવાથી ત્રણ મહિના જ જીવંત રહેવાની આશા સામે મળશે જીવનદાન
તપાસ: મુન્દ્રામાં વાહનચોર ટોળકીનો તરખાટ- એક જ રાતમાં 3 બાઈકની ઉઠાંતરી
ક્રાઇમ: ફેસબુક પર પ્રેમ થતાં સુરતથી આવેલા યુવકે થરાદ પંથકની સગીરા સાથે દુષ્કર્મ આચર્યું
અકસ્માત: લીમડી નજીક બે કાર અથડાતાં મહિલા સહિત 4 લોકો ઘાયલ
ટ્રાફીકની સમસ્યાનો અંત: ગોધરામાં 2 બ્રિજ અને 2 અંડર પાસ બનાવાશે
મોર્નિંગ ન્યૂઝ પોડકાસ્ટ: અમદાવાદ સહિત રાજ્યભરમાં કોલ્ડ વેવની આગાહી, કોરોનાના નવા 12911 કેસ સામે 23197 દર્દી ડિસ્ચાર્જ, 22નાં મોત
ભાસ્કર વિશેષ: ઉમરાયાની કંપનીએ નવ મહિનાથી પ્લાન્ટ બંધ કરવા છતાં કંપની કામદારોને ગુમરાહ કરતી હોવાનો આક્ષેપ
લોકોમાં ઉત્સુકતા: ડભોઇ- છોટાઉદેપુર વચ્ચે ઈલેક્ટ્રિક ટ્રેનનો ટ્રાયલ, શરૂ થવાની ફરી આશા
દરોડા: કડોલ પાસે વાડીમાંથી 2 લાખના શરાબ સાથે બે જબ્બે, 1 ફરાર
સન્માન: બોરિદ્રાના મુખ્ય શિક્ષકની કામગીરીને લોકોએે શિક્ષણ સેવા એવોર્ડથી બિરદાવી
ચોર-લૂંટારા બેફામ: નલિયામાં ધારાશાસ્ત્રીના ઘરમાં તસ્કરો ત્રાટક્યા : રોકડ, ચાંદીના સિક્કાની ચોરી
ચોરીનો ભેદ ઉકેલાયો: વાલિયા-નેત્રંગમાં પાઈપની ચોરીનો મામલો, પોલીસે 75.84 લાખના મુદ્દામાલ સાથે 17 ઈસમોને ઝડપી પાડ્યા
કુતૂહલ: ભરૂચની બાવા રેહાન દરગાહ પાસે ખોદકામ દરમ્યાન કબર મળતા લોકોમાં કુતુહુલ
છેતરપિંડી: કંડલાથી નિકળેલા કોલસામાં ભેળસેળ માટે 7 સામે ફોજદારી
કાર્યવાહી: બંદુક બતાવી મહિલા સાથે દુષ્કર્મ આચરનાર ઝડપાયો
કાર્યવાહી: અંતરજાળ ગામમાં 6.62 લાખના શંકાસ્પદ કાળા મરી સાથે બે પકડાયા
વિરોધ: પાલિકાની બોર્ડ મિટિંંગમાં હંગામો વિપક્ષે કામદારોને ઉષ્કેર્યાનો આક્ષેપ
તિરંગા યાત્રા: નર્મદા-તાપી વચ્ચે વસવાટ કરતાં લોકોને ન્યાય અપાવવા આંદોલન
આપઘાત: ત્રણ સંતાનના પિતાનો કુંવારી યુવતી સાથે તળાવમાં આપઘાત
સલામતી પર સવાલ ઉઠવા પામ્યા: સતત ધમધમતા કંડલામાં કોણ આવ્યું અને ગયું તે ચેક કરવા સીસીટીવી કેમેરાનો અભાવ
સન્માન: પાલિકામાં શહીદના પરિવારના આશ્રિતને કાયમી નોકરી અપાશે
હેરાફેરી: સ્માર્ટ ડસ્ટબિન, મલ્ટીલેવલ પાર્કિંગનાં કામો બજેટમાં રજૂ
તંત્ર નિદ્રાધીન: આદિપુરમાં હજુપણ બેરોકટોક ધમધમતી ‘જોખમી’ બેકરીઓ
વિરાસત: શહેરની જૂની પોળોનાં નામ સાથે સંક્ષિપ્ત ઇતિહાસની તકતી મૂકાશે
ઓનલાઈન સુવિધા: આવાસનાં ફોર્મ ઓનલાઈન જ ભરાશે, લોકો અટવાતાં એજન્ટોનો રાફડો ફાટશે
વિકાસ સતત બીજા વર્ષે ક્વોરન્ટાઈન: બજેટમાં 5 મોટાં કામોની જાહેરાત પણ આ વર્ષે એકેય નહીં થાય, 3 રિપીટ કર્યાં
એજ્યુકેશન: વીસીની ટર્મ પૂરી થતાં પૂર્વે નેકની જેમ કોન્વોકેશન યોજવા તૈયારી
નરકંકાલનો મામલો: કંકાલ કેસમાં DNA ટેસ્ટ:ગુમ લાલ બહાદુરની માતાના સેમ્પલ લેવાયા
વાક્સિનેશન: રસીકરણમાં બાકી રહેલાને 5 દિવસ દરરોજ સાંજે રસી અપાશે
વેપારીઓમાં ફફડાટ: ભુજમાં ફૂટવેરની દુકાનમાં પોણા કલાકમાં જ 80 હજાર રોકડની ચોરી
તમામ કંપનીના વાહનો મોંઘા: નવા વાહનોમાં ભાવ વધવાની ચિંતાથી ડિસેમ્બર મહિનામાં બુકિંગ વધારે થયું
પાલિકાની શાખ દાવ પર: વેપારીઓ મસમોટી રકમ માંગે છે, વાહન રિપેર કરવા કોઇ તૈયાર નથી
ફરિયાદ: ભાલ પંથકના સનેસ ગામે એકલા રહેતુ વૃદ્ધ દંપત્તિ લુંટાયુ
નિરાકરણ: કોરોના માટે ગ્રામ્ય કક્ષાએ 24 કલાક કંટ્રોલરૂમ કાર્યરત કરાયો
વીજ કાપ: આજે શહેરમાં પ્રમુખ દર્શન ફીડરના વિસ્તારોમાં વીજ કાપ જાહેર કરાયો
દુર્ઘટના: પતિ માંડવી ફરવા ન લઇ જતાં મુન્દ્રામાં પત્નીએ ફિનાઇલ પીને આત્મહત્યા કરી
વેધર: 18 કિલોમીટરની ઝંઝાવાતી ઝડપે પવનના સૂસવાટા ફૂંકાયા
કવાયત: અલંગ શિપ રિસાયકલિંગ ક્ષમતા બમણી કરવા માટેની કવાયત તેજ
વાયરસનું વિષચક્ર: કોરોનાનો સકંજો કૂણો પડ્યો, 2 દિવસમાં કોરોનાના કેસ મળ્યા તેનાથી સવા બે ગણા દર્દી રોગમુક્ત
